1111111111111111111111111111111111
1E000000000T000C00000C000000T00001
1010010100100000101001000000010101
1010010010101010001001000000010101
1P000T000C00C00000000000000T0000C1
1111111111111111111111111111111111